1111111111
1010000001
1010101001
1010000001
1011111001
1000001001
1011101001
1011101001
1010000001
1111111111